%%%%%%%%%
%       %
%       %
%R  T   %
%       %
%   M   %
%   S   %
%%%%%%%%%