%%%%%%%%%%%
%%%%R %%%%%
%%%%  %%%%%
%   T     %
%   M     %
%   T     %
%%%%  %%%%%
%%%%S %%%%%
%%%%  %%%%%
%         %
%    S    %
%%%%%%%%%%%