%%%%%%%%%%
%R       %
%   T  T %
%        %
%   M    %
%        %
%T S  S  %
%   S    %
%%%%%%%%%%