%%%%%%%
%R    %
%     %
%T  T %
%M    %
%S  S %
%%%%%%%