%%%%%%%%
%R     %
%      %
%      %
%      %
%     T%
%   M  %
%   S  %
%%%%%%%%