%%%%%%%%%%%%
%R         %
%  %%%%%   %
%      %   %
% %%%  %   %
% % T  %   %
% %    %   %
% %%%%%    %
%          %
%   M    % %
%   S    % %
%%%%%%%%%%%%