%%%%%%%%%%%%
%R         %
%          %
%          %
%        T %
%          %
%          %
%   M      %
%   S      %
%%%%%%%%%%%%