%%%%%%%%%%
%R      %%
%  %%%  %%
%  % T  %%
%  %%%  %%
%       %%
%%% %%%  %
%   %M   %
%   %S   %
%%%%%%%%%%