%%%%%
%   %
%R  %
%T  %
%M  %
%S  %
%%%%%