%%%%%%%%%%%%%%%
%R            %
%   %%% %%%   %
%   %     %   %
%   %  T  %   %
%   %     %   %
%   %%%%%%%   %
%             %
%             %
%  M          %
%  S          %
%%%%%%%%%%%%%%%